**********************************************
*		     		  ************
****************** * ******** *****	     *
****************** * * ****** ***** ******** *
* 		 * * *			   * *
* *********** ** *   ** ******************** *
* *********** ** * **** **                   *
* 	      ** * * ** ** ************** ** *
* ** ** ***** ** * *  * ** ************   ** *
* ** ** ***** ** * **	 	      ****** *
*		 * ********************	     *
*	**	   			     *
******* ** ***********  *********** **********
*	      *         *     ***** **       *
* ************* ******* *  **          ***** *
* ***********   *       ***** ***********  * *
*             *** *****       **             *
**********************************************
